??????????
<<<!!!!>>>
///!!!!///
%%%%%%%%%%
^^^^^^^^^^
&&&&&&&&&&
##########
**********
@@@0000@@@
0000000000